1111111
100C1E1
1P100C1
1111111